===SEG===
#########
#########
5555555##
444445###
33345###5
2345###54
345###543
45###5432
5###54322
###543333
##5444444
##5555555
#########
#########
#########



===SEG===
333333333
222222222
111111111
#########
4444#4444
334###433
34#####43
4#######4
#5#5#5#5#
#5#5#5#5#
#5#5#5#5#
#5#5#5#5#
#########
#########
#########



===SEG===
5554#4555
5443#3445
5433#3345
543###345
#53###35#
##1###1##
##1#5#1##
#43###34#
543###345
5433#3345
5445#5445
555###555
#########
#########
#########



===SEG===
522222225
251111152
215111512
211515112
211151112
211515112
215111512
251111152
522222225
#########
#########
#########
#########
#########
#########



===SEG===
111###111
11##2##11
1##333##1
##34443##
#2345432#
##34443##
###333###
1###2###1
11#####11
111###111
#########
#########
#########
#########
#########



===SEG===
#5#####5#
#21###12#
#2#1#1#2#
42##5##24
#2#1#1#2#
#21###12#
#2##4##2#
#21###12#
#2#1#1#2#
42##5##24
#2#1#1#2#
#21###12#
#5#####5#
#########
#########



===SEG===
321##1234
4321##123
34321##12
234321##1
1234321##
#1234321#
##1234321
###123432
1###12343
21###1234
321###123
4321###12
########1
#########
#########



===SEG===
#3111113#
##31113##
3##313##3
13##3##31
113###311
1113#3111
113###311
13##3##31
3##313##3
##31113##
#3111113#
#########
#########
#########
#########



===SEG===
311111113
#3111113#
#3111113#
##3###3##
##3###3##
###3#3###
#5##3##5#
#5#####5#
#########
##5###5##
##5#5#5##
####5####
#########
#########
#########



===SEG===
311111113
#3115113#
##31113##
2##313##2
22##3##22
2##313##2
##31113##
#3115113#
##31113##
2##313##2
22##3##22
#########
#########
#########
#########



===SEG===
11#3#3#11
1##444##1
##43#34##
#4#3#3#4#
#4#3#3###
##43#3#11
1##444##1
11#3#34##
###3#3#4#
#4#3#3#4#
##43#34##
###444###
###3#3###
#########
#########



===SEG===
#########
##23#32##
#213#312#
2113#3112
2113#3112
3333#3333
####5####
3333#3333
2113#3112
2113#3112
#213#312#
##23#32##
#########
#########
#########



===SEG===
#1#####1#
121###121
#1##1##1#
###121###
#1##1##1#
121###121
#1#####1#
########4
##1####45
#121##455
##1##455#
####555##
#########
#########
#########



===SEG===
#########
##11511##
#2225222#
153353351
125454521
123555321
####5####
123555321
125454521
153353351
#2225222#
##11511##
#########
#########
#########



===SEG===
123454321
#1234321#
##12321##
1##121##1
21##1##12
321###123
4321#1234
543212345
4321#1234
321###123
21#####12
1#######1
#########
#########
#########



===SEG===
###131###
##12321##
#1223221#
333353333
#1223221#
##12321##
###131###
333353333
###131###
##12321##
#1223221#
####5####
#########
#########
#########



===SEG===
###1#1###
#142#241#
42#3#3#24
#3#2#2#3#
#2#1#1#2#
#1#####1#
###1#1###
#142#241#
42#3#3#24
#3#2#2#3#
#2#1#1#2#
#1#####1#
#########
#########
#########



===SEG===
3###33333
31###1223
321###123
3221###13
33333###3
#########
#########
33333###3
3221###13
321###123
31###1223
3###33333
#########
#########
#########



===SEG===
####41314
##4##414#
#414##4##
41314####
#414##4##
##4##414#
####41314
##4##414#
#414##4##
41314####
#414#####
##4######
#########
#########
#########



===SEG===
3###5##31
13######3
113#5#2##
13######3
3###5##31
##2###311
3###5##31
13######3
113#5#2##
13######3
3###5##31
######311
#########
#########
#########